Team,Bronze,Silver,Gold,Total,Participants,Norm
China,225,318,320,863,4167,0.207103432
Netherlands,145,199,172,516,2317,0.22270177
United States of America,561,636,984,2181,7332,0.297463175
Finland,173,68,23,264,1552,0.170103093
Norway,124,114,149,387,1853,0.208850513
Romania,85,63,82,230,1805,0.127423823
France,224,189,169,582,4497,0.129419613
Estonia,12,6,7,25,732,0.034153005
Morocco,10,4,3,17,392,0.043367347
Spain,112,175,99,386,3052,0.126474443
Egypt,7,3,1,11,708,0.015536723
Italy,244,203,155,602,4537,0.132686797
Chad,0,0,0,0,21,0
Azerbaijan,25,12,7,44,283,0.155477032
Russia,399,360,389,1148,4862,0.236116824
Argentina,61,52,70,183,1356,0.134955752
Cuba,79,103,141,323,1254,0.257575758
Belarus,71,44,24,139,1787,0.077783996
Greece,23,32,21,76,1432,0.053072626
Cameroon,0,0,20,20,177,0.11299435
Turkey,18,14,16,48,626,0.076677316
Mexico,12,14,19,45,888,0.050675676
Chile,18,1,3,22,321,0.068535826
Nicaragua,0,0,0,0,67,0
Hungary,58,87,111,256,2044,0.125244618
Algeria,6,4,5,15,387,0.03875969
Bahrain,1,1,1,3,96,0.03125
Pakistan,16,0,0,16,157,0.101910828
Iraq,0,0,0,0,71,0
Qatar,4,1,0,5,153,0.032679739
Iran,14,10,14,38,332,0.114457831
Canada,210,244,288,742,4601,0.161269289
Ireland,6,7,5,18,582,0.030927835
Australia,352,305,232,889,4269,0.208245491
South Africa,22,19,15,56,1041,0.053794428
Eritrea,1,0,0,1,43,0.023255814
Libya,0,0,0,0,38,0
Sudan,0,1,0,1,39,0.025641026
Belgium,15,28,6,49,800,0.06125
Djibouti,0,0,0,0,29,0
Palestine,0,0,0,0,21,0
Comoros,0,0,0,0,19,0
Kazakhstan,32,25,20,77,1429,0.053883835
Brunei,0,0,0,0,10,0
Kuwait,2,0,0,2,125,0.016
Malaysia,5,11,0,16,288,0.055555556
United Arab Emirates,1,0,1,2,97,0.020618557
Indonesia,13,14,11,38,268,0.141791045
Singapore,4,3,1,8,221,0.036199095
Uzbekistan,17,7,10,34,495,0.068686869
Kyrgyzstan,2,1,0,3,227,0.013215859
Tajikistan,2,1,1,4,70,0.057142857
Unified Team,81,71,127,279,864,0.322916667
Japan,211,175,95,481,4129,0.116493098
Ethiopia,18,8,17,43,200,0.215
Germany,435,369,461,1265,5685,0.222515391
Sweden,88,181,95,364,2440,0.149180328
United States of America Virgin Islands,0,0,0,0,141,0
Sri Lanka,0,1,0,1,86,0.011627907
Armenia,9,5,2,16,221,0.07239819
Cote d'Ivoire,1,0,1,2,101,0.01980198
Kenya,20,29,20,69,396,0.174242424
Nigeria,40,29,23,92,559,0.164579606
Brazil,129,123,100,352,2329,0.151137827
Ukraine,100,52,47,199,2559,0.077764752
Ghana,20,0,0,20,170,0.117647059
Latvia,12,17,3,32,788,0.040609137
Syria,1,0,1,2,55,0.036363636
Lebanon,0,0,0,0,82,0
Mali,0,0,0,0,65,0
Switzerland,76,56,51,183,2123,0.086198775
India,9,4,1,14,574,0.024390244
Georgia,18,6,8,32,286,0.111888112
Slovenia,27,13,8,48,1111,0.04320432
Croatia,37,54,58,149,876,0.170091324
Guyana,0,0,0,0,41,0
Portugal,6,5,2,13,703,0.018492176
Bulgaria,41,31,15,87,1236,0.07038835
Poland,67,69,39,175,2431,0.071986837
Angola,0,0,0,0,217,0
Venezuela,5,1,1,7,521,0.013435701
Colombia,11,6,5,22,617,0.035656402
Bangladesh,0,0,0,0,42,0
Jordan,0,0,1,1,50,0.02
Somalia,0,0,0,0,14,0
Saudi Arabia,5,1,0,6,142,0.042253521
Puerto Rico,3,1,1,5,401,0.012468828
United Kingdom,187,178,199,564,3723,0.151490733
Uganda,1,0,1,2,95,0.021052632
Tunisia,5,1,2,8,359,0.022284123
Honduras,0,0,0,0,136,0
El Salvador,0,0,0,0,70,0
Turkmenistan,0,0,0,0,54,0
Mauritius,1,0,0,1,126,0.007936508
Seychelles,0,0,0,0,75,0
Czechoslovakia,28,3,4,35,417,0.083932854
Czechia,66,36,42,144,1874,0.076840982
Niger,0,1,0,1,30,0.033333333
Saint Kitts and Nevis,0,0,0,0,42,0
New Zealand,41,44,28,113,1411,0.080085046
Liberia,0,0,0,0,29,0
Suriname,1,0,0,1,44,0.022727273
Nepal,0,0,0,0,44,0
Mongolia,8,5,2,15,235,0.063829787
Palau,0,0,0,0,25,0
Lithuania,48,7,6,61,624,0.09775641
Namibia,0,4,0,4,77,0.051948052
American Samoa,0,0,0,0,31,0
Togo,1,0,0,1,40,0.025
Samoa,0,0,0,0,43,0
Rwanda,0,0,0,0,42,0
Dominica,0,0,0,0,19,0
Benin,0,0,0,0,38,0
Haiti,0,0,0,0,50,0
Denmark,50,34,85,169,1019,0.165848871
Malta,0,0,0,0,53,0
Austria,73,63,54,190,1723,0.11027278
Dominican Rep.,1,2,3,6,187,0.032085561
Panama,0,0,1,1,55,0.018181818
Belize,0,0,0,0,37,0
Trinidad and Tobago,10,6,6,22,207,0.106280193
Paraguay,0,17,0,17,94,0.180851064
Uruguay,0,1,0,1,126,0.007936508
Maldives,0,0,0,0,40,0
South Korea,144,161,186,491,2913,0.168554755
Mauritania,0,0,0,0,20,0
Peru,0,1,0,1,163,0.006134969
Bermuda,0,0,0,0,85,0
Serbia and Montenegro,26,26,12,64,321,0.199376947
Saint Vincent and the Grenadines,0,0,0,0,36,0
Cyprus,0,1,0,1,163,0.006134969
Papua New Guinea,0,0,0,0,72,0
Yemen,0,0,0,0,32,0
Individual Olympic Athletes,3,1,1,5,94,0.053191489
Oman,0,0,0,0,31,0
Fiji,0,0,13,13,146,0.089041096
Vanuatu,0,0,0,0,29,0
Jamaica,38,56,31,125,477,0.262054507
Moldova,5,3,0,8,234,0.034188034
Guatemala,0,1,0,1,168,0.005952381
Israel,7,1,1,9,388,0.023195876
Serbia,41,29,15,85,390,0.217948718
Monaco,0,0,0,0,89,0
British Virgin Islands,0,0,0,0,26,0
Iceland,1,14,0,15,273,0.054945055
Costa Rica,2,0,1,3,103,0.029126214
Central African Rep.,0,0,0,0,48,0
Madagascar,0,0,0,0,73,0
Bosnia and Herzegovina,0,0,0,0,134,0
Guam,0,0,0,0,85,0
Philippines,1,2,0,3,143,0.020979021
Cayman Islands,0,0,0,0,55,0
Slovakia,13,19,15,47,1055,0.044549763
Barbados,1,0,0,1,118,0.008474576
Ecuador,0,1,1,2,174,0.011494253
Guinea Bissau,0,0,0,0,21,0
Sierra Leone,0,0,0,0,48,0
Timor Leste,0,0,0,0,9,0
Dem. Rep. Congo,0,0,0,0,55,0
Gabon,0,1,0,1,56,0.017857143
Bahamas,13,11,12,36,221,0.162895928
San Marino,0,0,0,0,64,0
Thailand,11,7,9,27,401,0.067331671
Laos,0,0,0,0,32,0
Botswana,0,1,0,1,63,0.015873016
Refugee Olympic Athletes,0,0,0,0,12,0
North Korea,20,10,14,44,501,0.087824351
Mozambique,1,0,1,2,36,0.055555556
Solomon Islands,0,0,0,0,19,0
Cape Verde,0,0,0,0,18,0
Equatorial Guinea,0,0,0,0,28,0
Bolivia,0,0,0,0,78,0
Andorra,0,0,0,0,123,0
Antigua and Barbuda,0,0,0,0,64,0
Luxembourg,0,2,0,2,96,0.020833333
Zimbabwe,1,4,2,7,147,0.047619048
Grenada,0,1,1,2,41,0.048780488
Senegal,0,0,0,0,177,0
Hong Kong,1,2,1,4,347,0.011527378
Saint Lucia,0,0,0,0,28,0
Federated States of Micronesia,0,0,0,0,26,0
Myanmar,0,0,0,0,38,0
Afghanistan,2,0,0,2,20,0.1
Yugoslavia,0,0,0,0,60,0
Guinea,0,0,0,0,40,0
Taiwan,16,27,3,46,573,0.080279232
Sao Tome and Principe,0,0,0,0,15,0
Congo,0,0,0,0,47,0
Macedonia,1,0,0,1,84,0.011904762
Tonga,0,1,0,1,32,0.03125
Montenegro,0,14,0,14,94,0.14893617
Gambia,0,0,0,0,34,0
Tanzania,0,0,0,0,51,0
Mistral Hojris,0,0,0,0,1,0
Cook Islands,0,0,0,0,32,0
Albania,0,0,0,0,65,0
Relampago,0,0,0,0,1,0
Swaziland,0,0,0,0,37,0
Burundi,0,1,1,2,39,0.051282051
Aruba,0,0,0,0,30,0
Liechtenstein,0,0,0,0,124,0
Whitini Star,0,0,0,0,1,0
Nauru,0,0,0,0,13,0
Lucky Star,0,0,0,0,1,0
Briar,0,0,0,0,1,0
Gran Gesto,0,0,0,0,1,0
Zambia,0,1,0,1,55,0.018181818
Vietnam,0,3,1,4,104,0.038461538
Elvis Va,0,0,1,1,1,1
Netherlands Antilles,0,0,0,0,28,0
Cambodia,0,0,0,0,29,0
Malawi,0,0,0,0,24,0
Calimucho,0,0,0,0,1,0
Bhutan,0,0,0,0,24,0
Marshall Islands,0,0,0,0,14,0
Kiribati,0,0,0,0,11,0
Oxalis,0,0,0,0,1,0
Tuvalu,0,0,0,0,7,0
Kosovo,0,0,1,1,8,0.125
South Sudan,0,0,0,0,3,0
Don Schufro,1,0,0,1,1,1
Burkina Faso,0,0,0,0,34,0
Lancet,0,0,0,0,1,0
Whisper,0,0,0,0,1,0
Clearwater,1,0,0,1,1,1
Lesotho,0,0,0,0,46,0
Bonaparte,0,0,1,1,1,1
Mythilus,0,0,0,0,1,0
Rambo,0,0,0,0,1,0
Floresco,0,0,0,0,1,0
Brentina,0,0,0,0,1,0
Nadine,0,1,0,1,1,1
Pop Art,0,0,0,0,1,0
Quando Quando,0,0,0,0,1,0
Diabolo St Maurice,0,0,0,0,1,0
Ravel,0,0,0,0,1,0
Notavel,0,0,0,0,1,0
Galopin De La Font,0,0,0,0,1,0
Orion,0,0,0,0,1,0
Greenoaks Dundee,0,0,0,0,1,0
Sunrise,0,1,0,1,1,1
Salinero,0,1,0,1,1,1
Satchmo,0,0,1,1,1,1
Solos Carex,0,0,0,0,1,0
Dow Jones,0,0,0,0,1,0
Digby,1,0,0,1,1,1
